

NO ./textures/BRICK_1A.xpm
SO ./textures/BRICK_2B.xpm
WE ./textures/BRICK_3D.xpm
EA ./textures/CONCRETE_3C.xpm
DO ./textures/door.xpm

F 254,254,254
C 100,10,10

        1111111111111111111111111
        1002000000110000000000001
        1011000001110000000000001
        10010000002000N0200000001
111111111011000001110000000000001
100000000011000001112111111111111
11112111111111211100000010001
11110111111111011101010010001
11000000110101011100000020001
10000000000000001100000010001
10000000000000001101010010001
11000001110101011111011110001
11110111 1110101 101111010001
11111111 1111111 111111111111
